NO  textures/simonkraft/eagle.xpm
SO  textures/simonkraft/eagle.xpm   
WE  textures/simonkraft/eagle.xpm
EA  textures/simonkraft/eagle.xpm

F 20,20,20
C 200,200,200

 11111
10N0 1
11111

