NO textures/simonkraft/wet_sponge.png
SO textures/simonkraft/wet_sponge.png
WE textures/simonkraft/wet_sponge.png
EA textures/simonkraft/wet_sponge.png
F 100,100,100
C 200,200,255

1111111111111111111111111111
1000000000000000000000000001
1000000000000000000000000001
1000011111111000011111100001
1000010000011000010000100001
1000010000011000010000100001
1000010000011111110000100001
1000010000010000010000100001
1000011111110000011111100001
1000000000000000000000000001
100000000000N000000000000001
1111111111111111111111111111
