NO  textures/NSEW/N.xpm
SO  textures/NSEW/S.xpm  
WE  textures/NSEW/W.xpm
EA  textures/NSEW/E.xpm
F    100 , 100  ,  100
                C 200          ,  200 , 255   

   1111111111111111111111111
   1000000000110000000000001
   1011000001110000000000001
   1001000000000000000000001
   111111111011000001110000000000001
   1000000000         11000001110111111111111
11110111111111011100000010001
11110111111111011101010010001
11000000110101011100000010001
10000000000000001100000010001
10000000000000001101010010101
11000001 10101011111011111E1111
11110111 1110101 101111010101
11111111 1111111 111111111111