NO textures/simonkraft/eagle.xpm
SO textures/simonkraft/wet_sponge.xpm
WE textures/simonkraft/eagle.xpm
EA textures/simonkraft/wet_sponge.xpm

F 164,169,20
C 153,204,255

111111111111111111111
1N1000001000000000001
111111111111111111111
