NO  textures/NSEW/S.xpm
SO  textures/NSEW/W.xpm  
WE  textures/NSEW/W.xpm
EA  textures/NSEW/W.xpm
F 220,100,0
C 225,30,0

111111111
11111001
100000001
 101S00001
100101 001
11111 111