F 164,169,2
NO textures/simonkraft/eagle.xpm   
SO textures/simonkraft/eagle.xpm                  
WE textures/simonkraft/eagle.xpm   
EA textures/simonkraft/eagle.xpm
C +2,0,0   
11111
10001
1N11              
1011
1101